############
#....##..#.#
#.##..##...#
#..#...##..#
#..#..@.#..#
#..######..#
#..........#
############